RecipesKO {
	Dismantle_Clawhammer = "Disassemble Claw Hammer",
	BigMetalLocker(Shoddy) = "Big Metal Locker (Basic)",
	BrickDoorFrame(Good) = "Brick Doorframe (Craftsman)",
	BrickDoorFrame(Poor) = "Brick Doorframe (Basic)",
	BrickDoorFrame(Shoddy) = "Brick Door Frame ()",
	BrickFence(Good) = "Short Brick Wall",
	BrickWall(Good) = "Brick Wall (Craftsman)",
	BrickWall(Poor) = "Brick Wall (Basic)",
	BrickWindowFrame(Poor) = "Brick Window Frame (Basic)",
	Composter(Shoddy) = "Composter (Basic)",
	LogDoorFrame(Poor) = "Log Doorframe",
	LogWindowFrame(Poor) = "Log Window Frame",
	MetalCounter(Shoddy) = "Metal Counter (Basic)",
	MetalCounterCorner(Shoddy) = "Metal Counter Corner (Basic)",
	MetalCrate(Shoddy) = "Metal Crate (Basic)",
	MetalDoorFrame(Good) = "Metal Doorframe (Craftsman)",
	MetalDoorFrame(Poor) = "Metal Doorframe (Basic)",
	MetalFence(Good) = "Metal Fence (Craftsman)",
	MetalFence(Shoddy) = "Metal Fence (Basic)",
	MetalShelves(Shoddy) = "Metal Shelves (Basic)",
	MetalWall(Good) = "Metal Wall (Craftsman)",
	MetalWall(Poor) = "Metal Wall (Basic)",
	MetalWindowFrame(Poor) = "Metal Window Frame (Basic)",
	MetalWindowFrame(Shoddy) = "Metal Window Frame",
	SmallMetalLocker(Shoddy) = "Small Metal Locker (Basic)",
	SmallMetalPoleFence(Poor) = "Metal Pole Fence",
	SmallWoodTable(Good) = "Small Wooden Table (Craftsman)",
	SmallWoodTable(Poor) = "Small Wooden Table (Advanced)",
	SmallWoodTable(Shoddy) = "Small Wooden Table (Basic)",
	WoodBarElement(Good) = "Wooden Counter (Craftsman)",
	WoodBarElement(Poor) = "Wooden Counter (Advanced)",
	WoodBarElement(Shoddy) = "Wooden Counter (Basic)",
	WoodBarElementCorner(Good) = "Wooden Counter Corner (Craftsman)",
	WoodBarElementCorner(Poor) = "Wooden Counter Corner (Advanced)",
	WoodBarElementCorner(Shoddy) = "Wooden Counter Corner (Basic)",
	WoodBookcase(Good) = "Wooden Bookcase (Craftsman)",
	WoodBookcase(Poor) = "Wooden Bookcase (Advanced)",
	WoodBookcase(Shoddy) = "Wooden Bookcase (Basic)",
	WoodChair(Good) = "Wooden Chair (Craftsman)",
	WoodChair(Poor) = "Wooden Chair (Advanced)",
	WoodChair(Shoddy) = "Wooden Chair (Basic)",
	WoodCrate(Poor) = "Wooden Crate (Advanced)",
	WoodCrate(Shoddy) = "Wooden Crate (Basic)",
	WoodDoor(Good) = "Wooden Door (Craftsman)",
	WoodDoor(Poor) = "Wooden Door (Advanced)",
	WoodDoor(Shoddy) = "Wooden Door (Basic)",
	WoodDoorFrame(Good) = "Wooden Doorframe (Craftsman)",
	WoodDoorFrame(Poor) = "Wooden Doorframe (Advanced)",
	WoodDoorFrame(Shoddy) = "Wooden Doorframe (Basic)",
	WoodDoubleShelves(Good) = "Double Wooden Shelves (Craftsman)",
	WoodDoubleShelves(Poor) = "Double Wooden Shelves (Advanced)",
	WoodDoubleShelves(Shoddy) = "Double Wooden Shelves",
	WoodFence(Good) = "Wooden Fence (Craftsman)",
	WoodFence(Poor) = "Wooden Fence (Advanced)",
	WoodFence(Shoddy) = "Wooden Fence (Basic)",
	WoodFloor(Good) = "Wooden Floor (Craftsman)",
	WoodFloor(Shoddy) = "Wooden Floor (Basic)",
	WoodFloor(Poor) = "Wooden Floor (Advanced)",
	WoodShelves(Shoddy) = "Wooden Shelf (Basic)",
	WoodSmallBookcase(Good) = "Small Wooden Bookcase (Craftsman)",
	WoodSmallBookcase(Poor) = "Small Wooden Bookcase (Advanced)",
	WoodSmallBookcase(Shoddy) = "Small Wooden Bookcase (Basic)",
	WoodTable(Good) = "Wooden Table (Craftsman)",
	WoodTable(Poor) = "Wooden Table (Advanced)",
	WoodTable(Shoddy) = "Wooden Table (Basic)",
	WoodTablewithDrawer(Good) = "Wooden Table with Drawer (Craftsman)",
	WoodTablewithDrawer(Shoddy) = "Wooden Table with Drawer (Basic)",
	WoodenWall(Good) = "Wooden Wall (Craftsman)",
	WoodenWall(Poor) = "Wooden Wall (Advanced)",
	WoodWall(Shoddy) = "Wooden Wall (Basic)",
	WoodWindowFrame(Good) = "Wooden Window Frame (Craftsman)",
	WoodWindowFrame(Poor) = "Wooden Window Frame (Advanced)",
	WoodWindowFrame(Shoddy) = "Wooden Window Frame (Basic)",
}